AKAI | AKAI ETF
AKBC | AKBC ETF
AKCN | AKCN ETF
AKFB | AKFB ETF
AKFN | AKFN ETF
AKGD | AKGD ETF
AKGP | AKGP ETF
AKHT | AKHT ETF
AKIE | ETF AKIE
AKMB | ETF AKMB
AKME | ETF AKME
AKMM | AKMM ETF
AKMP | AKMP ETF
AKPP | AKPP ETF
AKQU | AKQU ETF
AKUP | AKUP ETF
AMFL | AMFL ETF
AMGB | AMGB ETF
AMGL | AMGL ETF
AMNR | AMNR ETF
AMNY | AMNY ETF
AMRE | AMRE ETF
AMRH | AMRH ETF
BCSB | BCSB ETF
BCSD | BCSD ETF
BCSE | BCSE ETF
BCSG | BCSG ETF
BCSR | BCSR ETF
BCSW | BCSW ETF
BNDA | BNDA ETF
BNDB | BNDB ETF
BNDC | BNDC ETF
BOND | BOND ETF
CASH | CASH ETF
CNYM | CNYM ETF
DIVD | ETF DIVD
EQMX | EQMX ETF
ESGE | ESGE ETF
ESGR | ESGR ETF
FINC | FINC ETF
FLOW | FLOW ETF
FMBR | FMBR ETF
FMMM | FMMM ETF
GOOD | GOOD ETF
GROD | ETF GROD
INFL | INFL ETF
INGO | INGO ETF
LQDT | LQDT ETF
MKBD | MKBD ETF
MONY | MONY ETF
OBLG | OBLG ETF
OPNB | OPNB ETF
OPNR | OPNR ETF
PRIE | PRIE ETF
PSGM | PSGM ETF
PSMM | PSMM ETF
PSRB | PSRB ETF
PSRE | PSRE ETF
RSHU | RSHU ETF
SAFE | SAFE ETF
SBBC | SBBC ETF
SBBY | SBBY ETF
SBCB | SBCB ETF
SBCN | SBCN ETF
SBDS | SBDS ETF
SBFR | SBFR ETF
SBGB | SBGB ETF
SBGD | SBGD ETF
SBHI | SBHI ETF
SBLB | SBLB ETF
SBMM | SBMM ETF
SBMX | SBMX ETF
SBPS | SBPS ETF
SBRB | SBRB ETF
SBRI | SBRI ETF
SBRS | SBRS ETF
SBSC | SBSC ETF
SCFT | SCFT ETF
SCLI | SCLI ETF
SILA | SILA ETF
SIPO | SIPO ETF
SMCF | SMCF ETF
STME | STME ETF
SUGB | SUGB ETF
TBEU | TBEU ETF
TBRU | TBRU ETF
TDIV | TDIV ETF
TEUR | TEUR ETF
TGLD | TGLD ETF
TITR | TITR ETF
TLCB | TLCB ETF
TMON | TMON ETF
TOFZ | TOFZ ETF
TPAY | TPAY ETF
TRND | TRND ETF
TRUR | TRUR ETF
TUSD | TUSD ETF
WILD | WILD ETF
YUAN | YUAN ETF